"year","nPos","nNeg","nTotal","propPos"
2008,0,2,2,0
2011,0,1,1,0
2012,0,1,1,0
2013,0,2,2,0
2014,0,1,1,0
